1  2  3  4  4  5  5  4  5  6  7  8  9  10  10  4  4  4  4  4  5  6  7  8  9  
11  12  13  14  14  15  15  14  15  16  17  18  19  20  20  15  15  15  15  15  15  16  17  18  19  
15  15  15  15  14  15  15  16  17  18  19  16  17  18  19  15  15  15  15  15  15  19  19  19  19  
15  15  15  15  15  15  15  15  15  15  15  15  15  15  15  15  15  15  15  15  15  19  19  19  19  
15  15  15  15  15  15  15  15  15  15  15  15  15  15  15  15  15  15  15  15  15  19  19  19  19  
15  15  15  15  15  15  15  15  15  15  15  15  15  15  15  15  15  15  15  15  15  19  19  19  19  
16  16  16  16  16  16  16  16  16  16  16  16  16  16  16  16  16  16  16  16  16  17  18  19  20  
26  26  26  26  26  26  26  26  26  26  26  26  26  26  26  27  27  27  27  27  27  27  28  29  30  
31  32  33  34  35  36  37  31  31  31  31  31  31  31  31  35  36  37  31  31  31  31  38  39  40  
41  42  43  44  45  46  47  41  41  41  41  41  41  41  41  45  46  47  41  41  41  41  48  49  50

 1 1   1   1   1   1   1   1   1   1   1   1   1   1   1   1   1   1   1   1   1   1   1   1   1  
 1  0  0  0  0  0  0  0  0  0  0  0  0  0  0  0  0  0  0  0  0  0  0  0   1  
 1  0  0  0  0  0  0  0  0  0  0  0  0  0  0  0  0  0  0  0  0  0  0  0   1  
 1  0  0  0  0  0  0  0  0  0  0  0  0  0  0  0  0  0  0  0  0  0  0  0   1  
 1  0  0  0  0  0  0  0  0  0  0  0  0  0  0  0  0  0  0  0  0  0  0  0   1  
 1  0  0  0  0  0  0  0  0  0  0  0  0  0  0  0  0  0  0  0  0  0  0  0   1  
 1  0  0  0  0  0  0  0  0  0  0  0  0  0  0  0  0  0  0  0  0  0  0  0   1  
 1  0  0  0  0  0  0  0  0  0  0  0  0  0  0  0  0  0  0  0  0  0  0  0   1  
 1  0   1  0   1   1  0  0  0  0  0  0  0  0  0   1   1  0  0  0  0  0  0  0   1  
 1   1   1   1   1   1   1   1   1   1   1   1   1   1   1   1   1   1   1   1   1   1   1   1   1

